(tuxjunior-level
  (version 2)
  (name (_ "AnimTiles"))
  (author "No Author")
  (sector
    (name "main")
    (ambient-light 1 1 1)
    (background
      (speed 0.5)
      (image "images/background/arctis.jpg")
    )
    (camera
      (mode "normal")
      (path
      )
    )
    (tilemap
      (z-pos -100)
      (solid #f)
      (width 30)
      (height 20)
      (tiles
      11 11 11 11 11 11 11 11 11 11 11 11 11 11 11 11 11 11 11 11 11 11 11 11 11 11 11 11 11 11
      11 11 11 11 11 11 11 11 11 11 11 11 11 11 11 11 11 11 11 11 11 11 11 11 11 11 11 11 11 11
      11 11 11 11 11 11 11 11 11 11 11 11 11 11 11 11 11 11 11 11 11 11 11 11 11 11 11 11 11 11
      11 11 11 11 11 11 11 11 11 11 11 11 11 11 11 11 11 11 11 11 11 11 11 11 11 11 11 11 11 11
      11 11 11 11 11 11 11 11 11 11 11 11 11 11 11 11 11 11 11 11 11 11 11 11 11 11 11 11 11 11
      11 11 11 11 11 11 11 11 11 11 11 11 11 11 11 11 11 11 11 11 11 11 11 11 11 11 11 11 11 11
      11 11 11 11 11 11 11 11 11 11 11 11 11 11 11 11 11 11 11 11 11 11 11 11 11 11 11 11 11 11
      11 11 11 11 11 11 11 11 11 11 11 11 11 11 11 11 11 11 11 11 11 11 11 11 11 11 11 11 11 11
      11 11 11 11 11 11 11 11 11 11 11 11 11 11 11 11 11 11 11 11 11 11 11 11 11 11 11 11 11 11
      11 11 11 11 11 11 11 11 11 11 11 11 11 11 11 11 11 11 11 11 11 11 11 11 11 11 11 11 11 11
      11 11 11 11 11 11 11 11 11 11 11 11 11 11 11 11 11 11 11 11 11 11 11 11 11 11 11 11 11 11
      11 11 11 11 11 11 11 11 11 11 11 11 11 11 11 11 11 11 11 11 11 11 11 11 11 11 11 11 11 11
      1873 1873 1873 1873 1873 1873 1873 1873 1873 1873 1873 1873 1873 1873 1873 1873 1873 1873 1873 1873 1873 1873 1873 1873 1873 1873 1873 1873 1873 1873
      1873 1873 1873 1873 1873 1873 1873 1873 1873 1873 1873 1873 1873 1873 1873 1873 1873 1873 1873 1873 1873 1873 1873 1873 1873 1873 1873 1873 1873 1873
      1873 1873 1873 1873 1873 1873 1873 1873 1873 1873 1873 1873 1873 1873 1873 1873 1873 1873 1873 1873 1873 1873 1873 1873 1873 1873 1873 1873 1873 1873
      1873 1873 1873 1873 1873 1873 1873 1873 1873 1873 1873 1873 1873 1873 1873 1873 1873 1873 1873 1873 1873 1873 1873 1873 1873 1873 1873 1873 1873 1873
      1956 1957 1958 1959 1956 1957 1958 1959 1956 1957 1956 1957 1958 1959 1956 1957 1958 1959 1956 1956 1957 1958 1959 1956 1957 1958 1959 1956 1957 1873
      1960 1961 1962 1963 1960 1961 1962 1963 1960 1961 1960 1961 1962 1963 1960 1961 1962 1963 1960 1960 1961 1962 1963 1960 1961 1962 1963 1960 1961 1873
      1964 1965 1966 1967 1964 1965 1966 1967 1964 1965 1964 1965 1966 1967 1964 1965 1966 1967 1964 1964 1965 1966 1967 1964 1965 1966 1967 1964 1965 1873
      1968 1969 1970 1971 1968 1969 1970 1971 1968 1969 1968 1969 1970 1971 1968 1969 1970 1971 1968 1968 1969 1970 1971 1968 1969 1970 1971 1968 1969 1873
      )
    )
    (tilemap
      (z-pos -50)
      (solid #f)
      (name "background float")
      (width 30)
      (height 20)
      (tiles
      0 0 0 0 0 0 0 0 0 0 0 2279 2280 2281 0 0 0 0 0 0 0 0 0 0 0 0 0 0 0 0
      0 0 0 0 0 0 0 0 0 0 0 2279 2280 2281 0 0 0 0 0 0 0 0 0 0 0 0 0 0 0 0
      0 0 0 0 0 0 0 0 0 0 0 2279 2280 2281 189 0 0 0 0 0 0 1779 1780 1781 0 0 0 0 0 0
      0 0 0 0 0 0 0 0 0 0 0 2279 2280 2281 193 0 0 0 0 0 0 1784 1785 1786 0 0 0 0 0 0
      0 0 0 0 0 0 0 0 0 0 0 2279 2280 2281 193 0 0 0 0 0 0 1789 1790 1791 0 0 0 0 0 0
      0 0 0 0 0 0 0 0 0 0 0 2279 2280 2281 185 0 0 0 0 0 0 1794 1795 1796 0 0 0 0 0 0
      0 0 0 0 0 0 0 0 0 0 0 2279 2280 2281 189 0 0 0 0 0 0 0 0 0 0 0 0 0 0 0
      0 0 0 0 0 0 0 0 0 0 0 2279 2280 2281 2282 2283 0 0 0 0 0 0 0 0 0 0 0 0 0 0
      0 0 0 0 0 0 0 0 0 0 0 2316 2317 2318 2319 2320 0 0 0 0 0 0 0 0 0 0 1779 0 0 0
      0 0 0 0 0 0 0 0 0 0 0 0 183 184 185 0 0 0 0 0 0 0 0 0 0 0 0 0 0 0
      0 0 0 0 0 0 0 0 0 0 0 0 187 188 189 0 0 0 0 0 0 0 0 0 0 0 0 0 0 0
      0 1860 1862 1863 1860 1861 1862 1863 1860 1863 0 0 191 192 193 1863 0 0 0 0 1860 1862 1863 1860 1861 1862 0 0 0 0
      1864 0 0 0 0 0 0 0 0 0 0 0 187 188 189 0 0 0 0 0 0 0 0 0 0 0 0 0 0 0
      1872 0 0 0 0 0 0 0 0 0 0 0 179 180 181 0 0 0 0 0 0 0 0 0 0 0 0 0 0 0
      0 0 0 0 0 0 0 0 0 0 0 0 179 180 181 0 0 0 0 0 0 0 0 0 0 0 0 0 0 0
      0 0 0 0 0 0 0 0 0 0 0 0 183 184 185 0 0 0 0 0 0 0 0 0 0 0 0 0 0 0
      0 0 0 0 0 0 0 0 0 0 0 0 187 188 189 0 0 0 0 0 0 0 0 0 0 0 0 0 0 0
      0 0 0 0 0 0 0 0 0 0 0 0 191 192 193 0 0 0 0 0 0 0 0 0 0 0 0 0 0 0
      0 0 0 0 0 0 0 0 0 0 0 0 0 0 0 0 0 0 0 0 0 0 0 0 0 0 0 0 0 0
      0 0 0 0 0 0 0 0 0 0 0 0 0 0 0 0 0 0 0 0 0 0 0 0 0 0 0 0 0 0
      )
    )
    (tilemap
      (z-pos 100)
      (solid #f)
      (width 30)
      (height 20)
      (tiles
      0 0 0 0 0 0 0 0 0 0 0 2279 2280 2281 2282 2283 0 0 0 0 0 0 0 0 0 0 0 0 0 0
      0 0 0 0 0 0 0 0 0 0 0 2279 2280 2281 2282 2283 0 0 0 0 0 0 0 0 0 0 0 0 0 0
      0 0 0 0 0 0 0 0 0 0 0 2279 2280 2281 2282 2283 0 0 0 0 0 0 0 0 0 0 0 0 0 0
      0 0 0 0 0 0 0 0 0 0 0 2279 2280 2281 2282 2283 0 0 0 0 0 0 0 0 0 0 0 0 0 0
      0 0 0 0 0 0 0 0 0 0 0 2279 2280 2281 2282 2283 0 0 0 0 0 0 0 0 0 0 0 0 0 0
      0 0 0 0 0 0 0 0 0 0 0 2279 2280 2281 2282 2283 0 0 0 0 0 0 0 0 0 0 0 0 0 0
      0 0 0 0 0 0 0 0 0 0 0 2279 2280 2281 2282 2283 0 0 0 0 0 0 0 0 0 0 0 0 0 0
      0 0 0 0 0 0 0 0 0 0 0 2279 2280 2281 2282 2283 0 0 0 0 0 0 0 0 0 0 0 0 0 0
      0 0 0 0 0 0 0 0 0 0 0 2316 2317 2318 2319 2320 0 0 0 0 0 0 0 0 0 0 0 0 0 0
      0 0 0 0 0 0 0 0 0 0 0 0 0 0 0 0 0 0 0 0 0 0 0 0 0 0 0 0 0 0
      0 0 0 0 0 0 0 0 0 0 0 0 0 0 0 0 0 0 0 0 0 0 0 0 0 0 0 0 0 0
      0 0 0 0 0 0 0 0 0 0 0 0 0 0 0 0 0 0 0 0 0 0 0 0 0 0 0 0 0 0
      0 0 0 0 0 0 0 0 0 0 0 2225 2226 2227 2228 2229 0 0 0 0 0 0 0 0 0 0 0 0 0 0
      0 0 0 0 0 0 0 0 0 0 0 2243 2298 2299 2300 2302 0 0 0 0 0 0 0 0 0 0 0 0 0 0
      0 0 0 0 0 0 0 0 0 0 0 2243 2244 2245 2246 2247 0 0 0 0 0 0 0 0 0 0 0 0 0 0
      0 0 0 0 0 0 0 0 0 0 0 2243 2244 2245 2246 2247 0 0 0 0 0 0 0 0 0 0 0 0 0 0
      0 0 0 0 0 0 0 0 0 0 0 2243 2244 2245 2246 2247 0 0 0 0 0 0 0 0 0 0 0 0 0 0
      0 0 0 0 0 0 0 0 0 0 0 2243 2244 2245 2246 2247 0 0 0 0 0 0 0 0 0 0 0 0 0 0
      0 0 0 0 0 0 0 0 0 0 0 2243 2244 2245 2246 2247 0 0 0 0 0 0 0 0 0 0 0 0 0 0
      0 0 0 0 0 0 0 0 0 0 0 2243 2244 2245 2246 2247 0 0 0 0 0 0 0 0 0 0 0 0 0 0
      )
    )
    (tilemap
      (z-pos 0)
      (solid #f)
      (width 30)
      (height 20)
      (tiles
      0 0 0 0 0 0 0 0 0 0 0 124 183 184 185 125 0 0 0 0 0 0 0 0 0 0 0 0 0 0
      0 0 0 0 0 0 0 0 0 0 0 124 187 188 189 125 0 0 0 0 0 0 0 0 0 0 0 0 0 0
      0 0 0 0 0 0 0 0 0 0 0 124 191 192 193 125 0 0 0 0 0 0 0 0 0 0 0 0 0 0
      0 0 0 0 0 0 0 0 0 0 0 124 187 188 189 125 0 0 0 0 0 0 0 0 0 0 0 0 0 0
      0 0 0 0 0 0 0 0 0 0 0 124 191 192 193 125 0 0 0 0 0 0 0 0 0 0 0 0 0 0
      0 0 0 0 0 0 0 0 0 0 0 124 183 184 185 125 0 0 0 0 0 0 0 0 0 0 0 0 0 0
      0 0 0 0 0 0 0 0 0 0 0 124 183 184 185 125 0 0 0 0 0 0 0 0 0 0 0 0 0 0
      0 0 0 0 0 0 0 0 0 0 0 124 183 184 185 125 0 0 0 0 0 0 0 0 0 0 0 0 0 0
      0 0 0 0 0 0 0 0 0 0 0 124 187 188 189 125 0 0 0 0 0 0 0 0 0 0 0 0 0 0
      0 0 0 0 0 0 0 0 0 0 0 124 191 192 193 125 0 0 0 0 0 0 0 0 0 0 0 0 0 0
      0 0 0 0 0 0 0 0 0 0 0 124 191 192 193 125 0 0 0 0 0 0 0 0 0 0 0 0 0 0
      0 0 0 0 0 0 0 0 0 0 0 124 191 192 193 125 0 0 0 0 0 0 0 0 0 0 0 0 0 0
      1389 0 0 0 0 0 0 0 0 0 0 124 187 188 189 125 0 0 0 0 0 0 0 0 0 0 0 0 0 0
      1374 0 0 0 0 0 0 0 0 0 0 124 191 192 193 125 0 0 0 0 0 0 0 0 0 0 0 0 0 0
      0 0 0 0 0 0 0 0 0 0 0 124 187 188 189 125 0 0 0 0 0 0 0 0 0 0 0 0 0 0
      0 0 0 0 0 0 0 0 0 0 0 124 191 192 193 125 0 0 0 0 0 0 0 0 0 0 0 0 0 0
      0 0 0 0 0 0 0 0 0 0 0 124 187 188 189 125 0 0 0 0 0 0 0 0 0 0 0 0 0 0
      1708 1708 1708 1708 1708 1708 1708 1708 1708 1708 1708 124 191 192 193 125 1708 1708 1708 1708 1708 1708 1708 1708 1708 1708 1708 1708 1708 1708
      1700 1705 1700 1705 1700 1705 1705 1700 1700 1700 1700 124 187 188 189 125 1705 1700 1705 1700 1705 1700 1705 1700 1705 1700 1705 1700 1705 1705
      1706 1706 1706 1706 1706 1706 1706 1706 1706 1706 1706 124 191 192 193 125 1706 1706 1706 1706 1706 1706 1706 1706 1706 1706 1706 1706 1706 1706
      )
    )
    (tilemap
      (z-pos 0)
      (solid #t)
      (width 30)
      (height 20)
      (tiles
      0 0 0 0 0 0 0 0 0 0 1542 0 0 0 0 0 1542 0 0 0 0 0 0 0 0 0 0 0 0 0
      0 0 0 0 0 0 0 0 0 0 1546 0 0 0 0 0 1546 0 0 0 0 0 0 0 0 0 0 0 0 0
      0 0 0 0 0 0 0 0 0 0 1546 0 0 0 0 0 1546 0 0 0 0 0 0 0 0 0 0 0 0 0
      0 0 0 0 0 0 0 0 0 0 1546 0 0 0 0 0 1546 0 0 0 0 0 0 0 0 0 0 0 0 0
      0 0 0 0 0 0 0 0 0 0 1546 0 0 0 0 0 1546 0 0 0 0 0 0 0 0 0 0 0 0 0
      0 0 0 0 0 0 0 0 0 0 1546 0 0 0 0 0 1546 0 0 0 0 0 0 0 0 0 0 0 0 0
      0 0 0 44 0 44 0 0 0 0 1546 0 0 0 0 0 1546 0 0 0 0 1367 1401 1368 1384 0 0 0 0 0
      0 0 44 0 44 0 44 0 0 0 1546 0 0 0 0 0 1546 0 0 0 0 1374 1375 1376 1399 0 0 0 0 0
      0 104 104 104 102 104 104 104 0 0 1550 0 0 0 0 0 1550 0 0 0 0 0 0 0 0 0 0 0 0 0
      0 0 0 0 0 0 0 0 0 0 0 0 0 0 0 0 0 0 0 0 0 0 0 0 0 0 0 0 0 0
      0 0 0 0 0 0 0 0 0 0 0 0 0 0 0 0 0 0 0 0 0 0 0 0 0 0 0 0 0 0
      0 0 0 0 0 0 0 0 0 0 0 0 0 0 0 0 0 0 0 0 0 0 0 0 0 0 0 0 0 0
      1545 1389 1390 1390 1391 1390 1390 1391 1390 1391 1542 1542 1551 1540 1541 1542 1542 1390 1391 1390 1391 1390 1391 1390 1391 1390 1391 1390 1391 1392
      1545 1404 1382 1382 1382 1405 1395 1382 1382 1382 1546 1546 0 0 0 1546 1546 1382 1395 1382 1382 1382 1382 1382 1382 1382 1405 1395 1395 1373
      1545 1374 1386 1387 1386 1387 1386 1387 1386 1387 1546 1546 0 0 0 1546 1546 1386 1387 1386 1387 1386 1387 1386 1387 1386 1387 1386 1387 1377
      1545 0 0 0 0 0 0 0 0 0 1546 1546 0 0 0 1546 1546 0 0 0 0 0 0 0 0 0 0 0 0 0
      1545 0 0 0 0 0 0 0 0 0 1546 1546 0 0 0 1546 1546 0 0 0 0 0 0 0 0 0 0 0 0 0
      1545 0 0 0 0 0 0 0 0 0 1546 1546 0 0 0 1546 1546 0 0 0 0 0 0 0 0 0 0 0 0 0
      1545 0 0 0 0 0 0 0 0 0 1546 1546 0 0 0 1546 1546 0 0 0 0 0 0 0 0 0 0 0 0 0
      1545 0 0 0 0 0 0 0 0 0 1546 1546 0 0 0 1546 1550 0 0 0 0 0 0 0 0 0 0 0 0 0
      )
    )
  )
)
