(tuxjunior-level
  (version 2)
  (name (_ "Unnamed"))
  (author "christoph")
  (sector
    (name "main")
    (ambient-light 1 1 1)
    (jumpy
      (x 288)
      (y 32)
    )
    (jumpy
      (x 416)
      (y 128)
    )
    (jumpy
      (x 544)
      (y 32)
    )
    (jumpy
      (x 640)
      (y 128)
    )
    (spawnpoint
      (name "main")
      (x 32)
      (y 96)
    )
    (weak_block
      (x 96)
      (y 192)
    )
    (weak_block
      (x 128)
      (y 192)
    )
    (weak_block
      (x 160)
      (y 192)
    )
    (weak_block
      (x 192)
      (y 192)
    )
    (weak_block
      (x 224)
      (y 192)
    )
    (weak_block
      (x 224)
      (y 160)
    )
    (weak_block
      (x 256)
      (y 192)
    )
    (weak_block
      (x 496)
      (y 0)
    )
    (weak_block
      (x 496)
      (y 32)
    )
    (weak_block
      (x 320)
      (y 192)
    )
    (weak_block
      (x 352)
      (y 192)
    )
    (weak_block
      (x 384)
      (y 192)
    )
    (weak_block
      (x 608)
      (y 192)
    )
    (weak_block
      (x 512)
      (y 192)
    )
    (weak_block
      (x 720)
      (y 224)
    )
    (weak_block
      (x 288)
      (y 192)
    )
    (weak_block
      (x 496)
      (y 64)
    )
    (weak_block
      (x 224)
      (y 32)
    )
    (weak_block
      (x 496)
      (y 160)
    )
    (weak_block
      (x 864)
      (y 0)
    )
    (weak_block
      (x 224)
      (y 96)
    )
    (weak_block
      (x 224)
      (y 64)
    )
    (weak_block
      (x 496)
      (y 128)
    )
    (weak_block
      (x 496)
      (y 224)
    )
    (weak_block
      (x 224)
      (y 128)
    )
    (weak_block
      (x 448)
      (y 192)
    )
    (weak_block
      (x 800)
      (y 192)
    )
    (weak_block
      (x 704)
      (y 192)
    )
    (weak_block
      (x 480)
      (y 192)
    )
    (weak_block
      (x 416)
      (y 192)
    )
    (weak_block
      (x 544)
      (y 192)
    )
    (weak_block
      (x 640)
      (y 192)
    )
    (weak_block
      (x 576)
      (y 192)
    )
    (weak_block
      (x 496)
      (y 96)
    )
    (weak_block
      (x 832)
      (y 192)
    )
    (weak_block
      (x 768)
      (y 192)
    )
    (weak_block
      (x 672)
      (y 192)
    )
    (weak_block
      (x 736)
      (y 192)
    )
    (weak_block
      (x 224)
      (y 0)
    )
    (weak_block
      (x 224)
      (y 224)
    )
    (weak_block
      (x 720)
      (y 160)
    )
    (weak_block
      (x 864)
      (y 160)
    )
    (weak_block
      (x 864)
      (y 128)
    )
    (weak_block
      (x 864)
      (y 96)
    )
    (weak_block
      (x 864)
      (y 64)
    )
    (weak_block
      (x 864)
      (y 32)
    )
    (weak_block
      (x 800)
      (y 192)
    )
    (powerup
      (x 32)
      (y 96)
      (sprite "images/powerups/fireflower/fireflower.sprite")
    )
    (powerup
      (script "      add_key(\"water\");
      Tux.deactivate();
      wait(0.5);
      Tux.do_cheer();
      end_level();
      ")
      (x 896)
      (y 128)
      (sprite "images/objects/keys/key_water.sprite")
    )
    (sequencetrigger
      (sequence "endsequence")
      (width 92)
      (height 72)
      (x 800)
      (y 372)
    )
    (secretarea
      (width 124)
      (height 124)
      (x 960)
      (y 64)
    )
    (background
      (y 400)
      (speed 0.5)
      (image-top "images/background/BlueRock_Forest/blue-top.jpg")
      (image "images/background/BlueRock_Forest/blue-middle.jpg")
      (image-bottom "images/background/BlueRock_Forest/blue-bottom.jpg")
    )
    (tilemap
      (z-pos -100)
      (solid #f)
      (speed 1)
      (width 64)
      (height 32)
      (tiles
      1904 1904 1904 1904 1904 1904 1904 1904 1904 1904 1904 1904 1904 1904 1904 1904 1904 1904 1904 1904 1904 1904 1904 1904 1904 1904 1904 1904 1904 1904 1904 1904 1904 1904 1904 1904 1904 1904 1904 1904 1904 1904 1904 1904 1904 1904 1904 1904 1906 1906 1906 1906 1906 1906 1906 1906 1906 1906 1906 1906 1906 1906 1906 1906
      1904 1904 1904 1904 1904 1904 1904 1904 1904 1904 1904 1904 1904 1904 1904 1904 1904 1904 1904 1904 1904 1904 1904 1904 1904 1904 1904 1904 1904 1904 1904 1904 1904 1904 1904 1904 1904 1904 1904 1904 1904 1904 1904 1904 1904 1904 1904 1904 1906 1906 1906 1906 1906 1906 1906 1906 1906 1906 1906 1906 1906 1906 1906 1906
      1904 1904 1904 1904 1904 1904 1904 1904 1904 1904 1904 1904 1904 1904 1904 1904 1904 1904 1904 1904 1904 1904 1904 1904 1904 1904 1904 1904 1904 1904 1904 1904 1904 1904 1904 1904 1904 1904 1904 1904 1904 1904 1904 1904 1904 1904 1904 1906 1906 1906 1906 1906 1906 1906 1906 1906 1906 1906 1906 1906 1906 1906 1906 1906
      1904 1904 1904 1904 1904 1904 1904 1904 1904 1904 1904 1904 1904 1904 1904 1904 1904 1904 1904 1904 1904 1904 1904 1904 1904 1904 1904 1904 1904 1904 1904 1904 1904 1904 1904 1904 1904 1904 1904 1904 1904 1904 1904 1904 1904 1904 1904 1906 1906 1906 1906 1906 1906 1906 1906 1906 1906 1906 1906 1906 1906 1906 1906 1906
      1904 1904 1904 1904 1904 1904 1904 1904 1904 1904 1904 1904 1904 1904 1904 1904 1904 1904 1904 1904 1904 1904 1904 1904 1904 1904 1904 1904 1904 1904 1904 1904 1904 1904 1904 1904 1904 1904 1904 1904 1904 1904 1904 1904 1904 1904 1904 1906 1906 1906 1906 1906 1906 1906 1906 1906 1906 1906 1906 1906 1906 1906 1906 1906
      1904 1904 1904 1904 1904 1904 1904 1904 1904 1904 1904 1904 1904 1904 1904 1904 1904 1904 1904 1904 1904 1904 1904 1904 1904 1904 1904 1904 1904 1904 1904 1904 1904 1904 1904 1904 1904 1904 1904 1904 1904 1904 1904 1904 1904 1904 1904 1906 1906 1906 1906 1906 1906 1906 1906 1906 1906 1906 1906 1906 1906 1906 1906 1906
      1904 1904 1904 1904 1904 1904 1904 1904 1904 1904 1904 1904 1904 1904 1904 1904 1904 1904 1904 1904 1904 1904 1904 1904 1904 1904 1904 1904 1904 1904 1904 1904 1904 1904 1904 1904 1904 1904 1904 1904 1904 1904 1904 1904 1904 1904 1904 1906 1906 1906 1906 1906 1906 1906 1906 1906 1906 1906 1906 1906 1906 1906 1906 1906
      1904 1904 1904 1904 1904 1904 1904 1904 1904 1904 1904 1904 1904 1904 1904 1904 1904 1904 1904 1904 1904 1904 1904 1904 1904 1904 1904 1904 1904 1904 1904 1904 1904 1904 1904 1904 1904 1904 1904 1904 1904 1904 1904 1904 1904 1904 1904 1906 1906 1906 1906 1906 1906 1906 1906 1906 1906 1906 1906 1906 1906 1906 1906 1906
      1904 1904 1904 1904 1904 1904 1904 1904 1904 1904 1904 1904 1904 1904 1904 1904 1904 1904 1904 1904 1904 1904 1904 1904 1904 1904 1904 1904 1904 1904 1904 1904 1904 1904 1904 1904 1904 1904 1904 1904 1904 1904 1904 1904 1904 1904 1904 1906 1906 1906 1906 1906 1906 1906 1906 1906 1906 1906 1906 1906 1906 1906 1906 1906
      1904 1904 1904 1904 1904 1904 1904 1904 1904 1904 1904 1904 1904 1904 1904 1904 1904 1904 1904 1904 1904 1904 1904 1904 1904 1904 1904 1904 1904 1904 1904 1904 1904 1904 1904 1904 1904 1904 1904 1904 1904 1904 1904 1904 1904 1904 1904 1906 1906 1906 1906 1906 1906 1906 1906 1906 1906 1906 1906 1906 1906 1906 1906 1906
      1902 1903 1904 1904 1904 1904 1900 1901 1902 1902 1903 1900 1904 1900 1901 1902 1902 1903 1904 1900 1901 1902 1903 1904 1904 1900 1901 1902 1903 1904 1904 1904 1900 1900 1900 1900 1900 1900 1900 1900 1901 1902 1903 1904 1904 1904 1904 1906 1906 1906 1906 1906 1906 1906 1906 1906 1906 1906 1906 1906 1906 1906 1906 1906
      1906 1907 1904 1904 1904 1904 1904 1905 1906 1906 1907 1904 1904 1904 1905 1906 1906 1907 1904 1904 1905 1906 1907 1904 1904 1904 1905 1906 1907 1904 1904 1904 1904 1904 1904 1904 1904 1904 1904 1904 1905 1906 1907 1904 1904 1904 1904 1906 1906 1906 1906 1906 1906 1906 1906 1906 1906 1906 1906 1906 1906 1906 1906 1906
      1910 1911 1904 1904 1904 1904 1908 1909 1910 1910 1911 1908 1904 1908 1909 1910 1910 1911 1904 1908 1909 1910 1911 1904 1904 1908 1909 1910 1911 1904 1904 1904 1908 1908 1908 1908 1908 1908 1908 1908 1909 1910 1911 1904 1904 1904 1904 1906 1906 1906 1906 1906 1906 1906 1906 1906 1906 1906 1906 1906 1906 1906 1906 1906
      1914 1915 1912 1912 1912 1912 1912 1913 1913 1914 1915 1912 1912 1912 1913 1913 1906 1915 1912 1912 1913 1906 1915 1912 1912 1912 1913 1906 1915 1912 1912 1912 1912 1912 1912 1912 1912 1912 1912 1912 1913 1906 1915 1912 1912 1912 1913 1906 1906 1906 1906 1906 1906 1906 1906 1906 1906 1906 1906 1906 1906 1906 1906 1906
      1900 1900 1901 1902 1903 1900 1901 1902 1903 1900 1541 1910 1910 1910 1910 1910 1910 1910 1910 1910 1910 1910 1910 1910 1910 1910 1910 1910 1910 1910 1910 1910 1910 1910 1910 1910 1910 1910 1910 1910 1910 1910 1910 1910 1910 1910 1904 1906 1906 1906 1906 1906 1906 1906 1906 1906 1906 1906 1906 1906 1906 1906 1906 1906
      1906 1906 1906 1906 1906 1906 1906 1906 1906 1906 1906 1906 1906 1906 1906 1906 1906 1906 1906 1906 1906 1906 1906 1906 1906 1906 1906 1906 1906 1906 1906 1906 1906 1906 1906 1906 1906 1906 1906 1906 1906 1906 1906 1906 1906 1906 1906 1906 1906 1906 1906 1906 1906 1906 1906 1906 1906 1906 1906 1906 1906 1906 1906 1906
      1906 1906 1906 1906 1906 1906 1906 1906 1906 1906 1906 1906 1906 1906 1906 1906 1906 1906 1906 1906 1906 1906 1906 1906 1906 1906 1906 1906 1906 1906 1906 1906 1906 1906 1906 1906 1906 1906 1906 1906 1906 1906 1906 1906 1906 1906 1906 1906 1906 1906 1906 1906 1906 1906 1906 1906 1906 1906 1906 1906 1906 1906 1906 1906
      1906 1906 1906 1906 1906 1906 1906 1906 1906 1906 1906 1906 1906 1906 1906 1906 1906 1906 1906 1906 1906 1906 1906 1906 1906 1906 1906 1906 1906 1906 1906 1906 1906 1906 1906 1906 1906 1906 1906 1906 1906 1906 1906 1906 1906 1906 1906 1906 1906 1906 1906 1906 1906 1906 1906 1906 1906 1906 1906 1906 1906 1906 1906 1906
      1906 1906 1906 1906 1906 1906 1906 1906 1906 1906 1906 1906 1906 1906 1906 1906 1906 1906 1906 1906 1906 1906 1906 1906 1906 1906 1906 1906 1906 1906 1906 1906 1906 1906 1906 1906 1906 1906 1906 1906 1906 1906 1906 1906 1906 1906 1906 1906 1906 1906 1906 1906 1906 1906 1906 1906 1906 1906 1906 1906 1906 1906 1906 1906
      1906 1906 1906 1906 1906 1906 1906 1906 1906 1906 1906 1906 1906 1906 1906 1906 1906 1906 1906 1906 1906 1906 1906 1906 1906 1906 1906 1906 1906 1906 1906 1906 1906 1906 1906 1906 1906 1906 1906 1906 1906 1906 1906 1906 1906 1906 1906 1906 1906 1906 1906 1906 1906 1906 1906 1906 1906 1906 1906 1906 1906 1906 1906 1906
      1906 1906 1906 1906 1906 1906 1906 1906 1906 1906 1906 1906 1906 1906 1906 1906 1906 1906 1906 1906 1906 1906 1906 1906 1906 1906 1906 1906 1906 1906 1906 1906 1906 1906 1906 1906 1906 1906 1906 1906 1906 1906 1906 1906 1906 1906 1906 1906 1906 1906 1906 1906 1906 1906 1906 1906 1906 1906 1906 1906 1906 1906 1906 1906
      1906 1906 1906 1906 1906 1906 1906 1906 1906 1906 1906 1906 1906 1906 1906 1906 1906 1906 1906 1906 1906 1906 1906 1906 1906 1906 1906 1906 1906 1906 1906 1906 1906 1906 1906 1906 1906 1906 1906 1906 1906 1906 1906 1906 1906 1906 1906 1906 1906 1906 1906 1906 1906 1906 1906 1906 1906 1906 1906 1906 1906 1906 1906 1906
      1906 1906 1906 1906 1906 1906 1906 1906 1906 1906 1906 1906 1906 1906 1906 1906 1906 1906 1906 1906 1906 1906 1906 1906 1906 1906 1906 1906 1906 1906 1906 1906 1906 1906 1906 1906 1906 1906 1906 1906 1906 1906 1906 1906 1906 1906 1906 1906 1906 1906 1906 1906 1906 1906 1906 1906 1906 1906 1906 1906 1906 1906 1906 1906
      1906 1906 1906 1906 1906 1906 1906 1906 1906 1906 1906 1906 1906 1906 1906 1906 1906 1906 1906 1906 1906 1906 1906 1906 1906 1906 1906 1906 1906 1906 1906 1906 1906 1906 1906 1906 1906 1906 1906 1906 1906 1906 1906 1906 1906 1906 1906 1906 1906 1906 1906 1906 1906 1906 1906 1906 1906 1906 1906 1906 1906 1906 1906 1906
      1906 1906 1906 1906 1906 1906 1906 1906 1906 1906 1906 1906 1906 1906 1906 1906 1906 1906 1906 1906 1906 1906 1906 1906 1906 1906 1906 1906 1906 1906 1906 1906 1906 1906 1906 1906 1906 1906 1906 1906 1906 1906 1906 1906 1906 1906 1906 1906 1906 1906 1906 1906 1906 1906 1906 1906 1906 1906 1906 1906 1906 1906 1906 1906
      1906 1906 1906 1906 1906 1906 1906 1906 1906 1906 1906 1906 1906 1906 1906 1906 1906 1906 1906 1906 1906 1906 1906 1906 1906 1906 1906 1906 1906 1906 1906 1906 1906 1906 1906 1906 1906 1906 1906 1906 1906 1906 1906 1906 1906 1906 1906 1906 1906 1906 1906 1906 1906 1906 1906 1906 1906 1906 1906 1906 1906 1906 1906 1906
      1906 1906 1906 1906 1906 1906 1906 1906 1906 1906 1906 1906 1906 1906 1906 1906 1906 1906 1906 1906 1906 1906 1906 1906 1906 1906 1906 1906 1906 1906 1906 1906 1906 1906 1906 1906 1906 1906 1906 1906 1906 1906 1906 1906 1906 1906 1906 1906 1906 1906 1906 1906 1906 1906 1906 1906 1906 1906 1906 1906 1906 1906 1906 1906
      1906 1906 1906 1906 1906 1906 1906 1906 1906 1906 1906 1906 1906 1906 1906 1906 1906 1906 1906 1906 1906 1906 1906 1906 1906 1906 1906 1906 1906 1906 1906 1906 1906 1906 1906 1906 1906 1906 1906 1906 1906 1906 1906 1906 1906 1906 1906 1906 1906 1906 1906 1906 1906 1906 1906 1906 1906 1906 1906 1906 1906 1906 1906 1906
      1906 1906 1906 1906 1906 1906 1906 1906 1906 1906 1906 1906 1906 1906 1906 1906 1906 1906 1906 1906 1906 1906 1906 1906 1906 1906 1906 1906 1906 1906 1906 1906 1906 1906 1906 1906 1906 1906 1906 1906 1906 1906 1906 1906 1906 1906 1906 1906 1906 1906 1906 1906 1906 1906 1906 1906 1906 1906 1906 1906 1906 1906 1906 1906
      1906 1906 1906 1906 1906 1906 1906 1906 1906 1906 1906 1906 1906 1906 1906 1906 1906 1906 1906 1906 1906 1906 1906 1906 1906 1906 1906 1906 1906 1906 1906 1906 1906 1906 1906 1906 1906 1906 1906 1906 1906 1906 1906 1906 1906 1906 1906 1906 1906 1906 1906 1906 1906 1906 1906 1906 1906 1906 1906 1906 1906 1906 1906 1906
      1906 1906 1906 1906 1906 1906 1906 1906 1906 1906 1906 1906 1906 1906 1906 1906 1906 1906 1906 1906 1906 1906 1906 1906 1906 1906 1906 1906 1906 1906 1906 1906 1906 1906 1906 1906 1906 1906 1906 1906 1906 1906 1906 1906 1906 1906 1906 1906 1906 1906 1906 1906 1906 1906 1906 1906 1906 1906 1906 1906 1906 1906 1906 1906
      1906 1906 1906 1906 1906 1906 1906 1906 1906 1906 1906 1906 1906 1906 1906 1906 1906 1906 1906 1906 1906 1906 1906 1906 1906 1906 1906 1906 1906 1906 1906 1906 1906 1906 1906 1906 1906 1906 1906 1906 1906 1906 1906 1906 1906 1906 1906 1906 1906 1906 1906 1906 1906 1906 1906 1906 1906 1906 1906 1906 1906 1906 1906 1906
      )
    )
    (tilemap
      (z-pos 0)
      (solid #t)
      (speed 1)
      (width 64)
      (height 32)
      (tiles
      0 0 0 0 0 0 0 0 0 0 0 0 0 0 0 0 0 0 0 0 0 0 0 0 0 0 0 0 0 0 0 0 0 0 1545 0 0 0 0 0 0 0 0 0 0 0 0 1545 0 0 0 0 0 0 0 0 0 0 0 0 0 0 0 0
      0 0 0 0 0 0 0 0 0 0 0 0 0 0 0 0 0 0 0 0 0 0 0 0 0 0 0 0 0 0 0 0 0 0 1545 0 0 0 0 0 0 0 0 0 0 0 1545 1545 1545 1545 1545 1545 1545 1545 1545 1545 1545 1545 1545 1545 1545 1545 1545 1545
      0 0 0 0 0 0 0 0 0 0 0 0 0 0 0 0 0 0 0 0 0 0 0 0 0 0 0 0 0 0 0 0 0 0 1545 0 0 0 0 0 0 0 0 0 0 0 1545 0 1545 1545 1545 1545 1545 1545 1545 1545 1545 1545 1545 1545 1545 1545 1545 1545
      0 0 0 0 0 0 0 0 0 0 0 0 0 0 0 0 0 0 0 0 0 0 0 0 0 0 0 0 0 0 0 0 0 0 1545 0 0 0 0 0 0 0 0 0 0 0 1545 1545 1545 1545 1545 1545 1545 1545 1545 1545 1545 1545 1545 1545 1545 1545 1545 1545
      0 0 0 0 0 0 0 0 0 0 0 0 0 0 0 0 0 0 0 0 0 0 0 0 0 0 0 0 0 0 0 0 0 0 1545 0 0 0 0 0 0 0 0 0 0 0 1545 1545 1545 1545 1545 1545 1545 1545 1545 1545 1545 1545 1545 1545 1545 1545 1545 1545
      0 0 0 0 0 0 0 0 0 0 0 0 0 0 0 0 0 0 0 0 0 0 0 0 0 0 0 0 0 0 0 0 0 0 1545 0 0 0 0 0 0 0 0 0 0 0 1545 1545 1545 1545 1545 1545 1545 1545 1545 1545 1545 1545 1545 1545 1545 1545 1545 1545
      48 48 48 0 0 0 0 0 0 0 0 0 0 0 0 0 0 0 0 0 0 0 0 0 0 0 0 1545 1545 1545 1545 1545 1545 1545 1545 0 0 0 0 0 0 0 0 0 0 0 1545 1545 1545 1545 1545 1545 1545 1545 1545 1545 1545 1545 1545 1545 1545 1545 1545 1545
      0 0 0 0 0 0 0 0 0 0 0 0 0 0 0 0 0 0 0 0 0 0 0 0 0 0 1545 0 0 0 0 0 0 0 0 0 0 0 0 0 0 0 0 0 0 0 1545 1545 1545 1545 1545 1545 1545 1545 1545 1545 1545 1545 1545 1545 1545 1545 1545 1545
      0 0 0 0 0 0 0 0 0 0 0 0 0 0 0 0 0 0 0 0 0 0 0 0 0 0 0 0 0 0 0 0 0 0 0 0 0 0 0 0 0 0 0 0 0 0 1545 1545 1545 1545 1545 1545 1545 1545 1545 1545 1545 1545 1545 1545 1545 1545 1545 1545
      0 0 0 0 0 0 0 0 0 0 0 0 0 0 0 0 0 0 0 0 0 0 0 0 0 0 0 0 0 0 0 0 0 0 0 0 0 0 0 0 0 0 0 0 0 0 1545 1545 1545 1545 1545 1545 1545 1545 1545 1545 1545 1545 1545 1545 1545 1545 1545 1545
      0 0 0 0 0 0 0 0 0 0 0 0 0 0 0 0 0 0 0 0 0 0 0 0 0 0 0 0 0 0 0 0 0 0 0 0 0 0 0 0 0 0 0 0 0 0 1545 1545 1545 1545 1545 1545 1545 1545 1545 1545 1545 1545 1545 1545 1545 1545 1545 1545
      0 0 0 0 0 0 0 0 0 0 0 0 0 0 0 0 0 0 0 0 0 0 0 0 0 0 0 0 0 0 0 0 0 0 0 0 0 0 0 0 0 0 0 0 0 0 1545 1545 1545 1545 1545 1545 1545 1545 1545 1545 1545 1545 1545 1545 1545 1545 1545 1545
      0 0 0 0 0 0 0 0 0 0 0 0 0 0 0 0 0 0 0 0 0 0 0 0 0 0 0 0 0 0 0 0 0 0 0 0 0 0 0 0 0 0 0 0 0 0 1545 1545 1545 1545 1545 1545 1545 1545 1545 1545 1545 1545 1545 1545 1545 1545 1545 1545
      0 0 0 0 0 0 0 0 0 0 0 0 0 0 0 0 0 0 0 0 0 0 0 0 0 0 0 0 0 0 0 0 0 0 0 0 0 0 0 0 0 0 0 0 0 0 1545 1545 1545 1545 1545 1545 1545 1545 1545 1545 1545 1545 1545 1545 1545 1545 1545 1545
      1551 1540 1540 1540 1540 1540 1540 1540 1540 1540 1541 0 0 0 0 1551 1540 1540 1540 1540 1540 1540 1540 1540 1540 1540 1540 1540 1540 1540 1540 1540 1540 1540 1540 1540 1540 1540 1540 1540 1540 1540 1540 1540 1540 1540 1541 1545 1545 1545 1545 1545 1545 1545 1545 1545 1545 1545 1545 1545 1545 1545 1545 1545
      0 0 1545 1545 1545 1545 1545 1545 1545 1545 1551 1540 1540 1540 1540 1541 1545 1545 1545 1545 1545 1545 1545 1545 1545 1545 1545 1545 1545 1545 1545 1545 1545 0 0 0 0 0 0 0 0 0 0 0 0 1545 1545 1545 1545 1545 1545 1545 1545 1545 1545 1545 1545 1545 1545 1545 1545 1545 1545 1545
      0 0 1545 0 0 0 0 0 1545 1545 1545 1545 1545 1545 1545 1545 1545 0 0 1545 0 1545 0 0 0 0 0 0 1545 0 0 0 1545 0 0 0 0 0 0 0 0 0 0 0 0 1545 1545 1545 1545 1545 1545 1545 1545 1545 1545 1545 1545 1545 1545 1545 1545 1545 1545 1545
      0 0 1545 1545 1545 1545 1545 1545 1545 0 0 0 0 1545 0 0 1545 0 0 1545 0 1545 0 1545 0 0 1545 0 1545 0 0 0 1545 0 0 0 0 0 0 0 0 0 0 0 0 1545 1545 1545 1545 1545 1545 1545 1545 1545 1545 1545 1545 1545 1545 1545 1545 1545 1545 1545
      0 0 1545 0 0 0 1545 0 1545 1545 1545 1545 1545 1545 0 0 1545 0 0 1545 0 1545 0 0 0 0 0 0 1545 0 0 0 1545 0 0 0 0 0 0 0 0 0 0 0 0 1545 1545 1545 1545 1545 1545 1545 1545 1545 1545 1545 1545 1545 1545 1545 1545 1545 1545 1545
      0 0 1545 0 0 0 1545 0 1545 0 0 0 0 1545 0 0 1545 0 0 1545 0 1545 1545 1545 1545 1545 1545 1545 1545 1545 1545 1545 1545 0 0 0 0 0 0 0 0 0 0 0 0 1545 1545 1545 1545 1545 1545 1545 1545 1545 1545 1545 1545 1545 1545 1545 1545 1545 1545 1545
      0 0 1545 0 0 0 1545 0 1545 1545 1545 1545 1545 1545 1545 1545 1545 1545 1545 1545 0 1545 0 0 0 0 0 0 0 0 0 0 1545 0 0 0 0 0 0 0 0 0 0 0 0 1545 1545 1545 1545 1545 1545 1545 1545 1545 1545 1545 1545 1545 1545 1545 1545 1545 1545 1545
      0 0 1545 1545 1545 1545 1545 1545 1545 0 0 0 0 1545 0 0 0 0 0 1545 0 1545 0 0 0 0 0 0 0 0 0 0 1545 0 0 0 0 0 0 0 0 0 0 0 0 1545 1545 1545 1545 1545 1545 1545 1545 1545 1545 1545 1545 1545 1545 1545 1545 1545 1545 1545
      0 0 1545 0 0 0 0 0 1545 0 0 0 0 1545 0 0 0 0 0 1545 0 0 0 0 0 0 0 0 0 0 0 0 1545 0 0 0 0 0 0 0 0 0 0 0 0 1545 1545 1545 1545 1545 1545 1545 1545 1545 1545 1545 1545 1545 1545 1545 1545 1545 1545 1545
      0 0 1545 0 0 0 0 0 1545 0 0 0 0 1545 0 0 0 0 0 1545 0 0 0 0 0 0 0 0 0 0 0 0 1545 0 0 0 0 0 0 0 0 0 0 0 0 1545 1545 1545 1545 1545 1545 1545 1545 1545 1545 1545 1545 1545 1545 1545 1545 1545 1545 1545
      0 0 1545 0 0 0 0 0 1545 0 0 0 0 1545 0 0 0 0 0 1545 0 0 0 0 0 0 0 0 0 0 0 0 1545 0 0 0 0 0 0 0 0 0 0 0 0 1545 1545 1545 1545 1545 1545 1545 1545 1545 1545 1545 1545 1545 1545 1545 1545 1545 1545 1545
      0 0 1545 0 0 0 0 0 1545 0 0 0 0 1545 0 0 0 0 0 1545 0 0 0 0 0 0 0 0 0 0 0 0 1545 0 0 0 0 0 0 0 0 0 0 0 0 1545 1545 1545 1545 1545 1545 1545 1545 1545 1545 1545 1545 1545 1545 1545 1545 1545 1545 1545
      0 0 1545 0 0 0 0 0 1545 0 0 0 0 1545 0 0 0 0 0 1545 0 0 0 0 0 0 0 0 0 0 0 0 1545 0 0 0 0 0 0 0 0 0 0 0 0 1545 1545 1545 1545 1545 1545 1545 1545 1545 1545 1545 1545 1545 1545 1545 1545 1545 1545 1545
      0 0 1545 0 0 0 0 0 1545 0 0 0 0 1545 0 0 0 0 0 1545 0 0 0 0 0 0 0 0 0 0 0 0 1545 0 0 0 0 0 0 0 0 0 0 0 0 1545 1545 1545 1545 1545 1545 1545 1545 1545 1545 1545 1545 1545 1545 1545 1545 1545 1545 1545
      0 0 1545 0 0 0 0 0 1545 0 0 0 0 1545 0 0 0 0 0 1545 0 0 0 0 0 0 0 0 0 0 0 0 1545 0 0 0 0 0 0 0 0 0 0 0 0 1545 1545 1545 1545 1545 1545 1545 1545 1545 1545 1545 1545 1545 1545 1545 1545 1545 1545 1545
      0 0 1545 0 0 0 0 0 1545 0 0 0 0 1545 0 0 0 0 0 1545 0 0 0 0 0 0 0 0 0 0 0 0 1545 0 0 0 0 0 0 0 0 0 0 0 0 1545 1545 1545 1545 1545 1545 1545 1545 1545 1545 1545 1545 1545 1545 1545 1545 1545 1545 1545
      0 0 1545 0 0 0 0 0 1545 0 0 0 0 1545 0 0 0 0 0 1545 0 0 0 0 0 0 0 0 0 0 0 0 1545 0 0 0 0 0 0 0 0 0 0 0 0 1545 1545 1545 1545 1545 1545 1545 1545 1545 1545 1545 1545 1545 1545 1545 1545 1545 1545 1545
      0 0 1545 0 0 0 0 0 1545 0 0 0 0 1545 0 0 0 0 0 1545 0 0 0 0 0 0 0 0 0 0 0 0 1545 0 0 0 0 0 0 0 0 0 0 0 0 1545 1545 1545 1545 1545 1545 1545 1545 1545 1545 1545 1545 1545 1545 1545 1545 1545 1545 1545
      )
    )
    (tilemap
      (z-pos 100)
      (solid #f)
      (speed 1)
      (width 64)
      (height 32)
      (tiles
      0 0 0 0 0 0 0 0 0 0 0 0 0 0 0 0 0 0 0 0 0 0 0 0 0 0 0 0 0 0 0 0 0 0 0 0 0 0 0 0 0 0 0 0 0 0 0 0 0 0 0 0 0 0 0 0 0 0 0 0 0 0 0 0
      0 0 0 0 0 0 0 0 0 0 0 0 0 0 0 0 0 0 0 0 0 0 0 0 0 0 0 0 0 0 0 0 0 0 0 0 0 0 0 0 0 0 0 0 0 0 0 0 0 0 0 0 0 0 0 0 0 0 0 0 0 0 0 0
      0 0 0 0 0 0 0 0 0 0 0 0 0 0 0 0 0 0 0 0 0 0 0 0 0 0 0 0 0 0 0 0 0 0 0 0 0 0 0 0 0 0 0 0 0 0 0 0 0 0 0 0 0 0 0 0 0 0 0 0 0 0 0 0
      0 0 0 0 0 0 0 0 0 0 0 0 0 0 0 0 0 0 0 0 0 0 0 0 0 0 0 0 0 0 0 0 0 0 0 0 0 0 0 0 0 0 0 0 0 0 0 0 0 0 0 0 0 0 0 0 0 0 0 0 0 0 0 0
      0 0 0 0 0 0 0 0 0 0 0 0 0 0 0 0 0 0 0 0 0 0 0 0 0 0 0 0 0 0 0 0 0 0 0 0 0 0 0 0 0 0 0 0 0 0 0 0 0 0 0 0 0 0 0 0 0 0 0 0 0 0 0 0
      0 0 0 0 0 0 0 0 0 0 0 0 0 0 0 0 0 0 0 0 0 0 0 0 0 0 0 0 0 0 0 0 0 0 0 0 0 0 0 0 0 0 0 0 0 0 0 0 0 0 0 0 0 0 0 0 0 0 0 0 0 0 0 0
      0 0 0 0 0 0 0 0 0 0 0 0 0 0 0 0 0 0 0 0 0 0 0 0 0 0 0 0 0 0 0 0 0 0 0 0 0 0 0 0 0 0 0 0 0 0 0 0 0 0 0 0 0 0 0 0 0 0 0 0 0 0 0 0
      0 0 0 0 0 0 0 0 0 0 0 0 0 0 0 0 0 0 0 0 0 0 0 0 0 0 0 0 0 0 0 0 0 0 0 0 0 0 0 0 0 0 0 0 0 0 0 0 0 0 0 0 0 0 0 0 0 0 0 0 0 0 0 0
      0 0 0 0 0 0 0 0 0 0 0 0 0 0 0 0 0 0 0 0 0 0 0 0 0 0 0 0 0 0 0 0 0 0 0 0 0 0 0 0 0 0 0 0 0 0 0 0 0 0 0 0 0 0 0 0 0 0 0 0 0 0 0 0
      0 0 0 0 0 0 0 0 0 0 0 0 0 0 0 0 0 0 0 0 0 0 0 0 0 0 0 0 0 0 0 0 0 0 0 0 0 0 0 0 0 0 0 0 0 0 0 0 0 0 0 0 0 0 0 0 0 0 0 0 0 0 0 0
      0 0 0 0 0 0 0 0 0 0 0 0 0 0 0 0 0 0 0 0 0 0 0 0 0 0 0 0 0 0 0 0 0 0 0 0 0 0 0 0 0 0 0 0 0 0 0 0 0 0 0 0 0 0 0 0 0 0 0 0 0 0 0 0
      0 0 0 0 0 0 0 0 0 0 0 0 0 0 0 0 0 0 0 0 0 0 0 0 0 0 0 0 0 0 0 0 0 0 0 0 0 0 0 0 0 0 0 0 0 0 0 0 0 0 0 0 0 0 0 0 0 0 0 0 0 0 0 0
      0 0 0 0 0 0 0 0 0 0 0 0 0 0 0 0 0 0 0 0 0 0 0 0 0 0 0 0 0 0 0 0 0 0 0 0 0 0 0 0 0 0 0 0 0 0 0 0 0 0 0 0 0 0 0 0 0 0 0 0 0 0 0 0
      0 0 0 0 0 0 0 0 0 0 0 0 0 0 0 0 0 0 0 0 0 0 0 0 0 0 0 0 0 0 0 0 0 0 0 0 0 0 0 0 0 0 0 0 0 0 0 0 0 0 0 0 0 0 0 0 0 0 0 0 0 0 0 0
      0 0 0 0 0 0 0 0 0 0 0 0 0 0 0 0 0 0 0 0 0 0 0 0 0 0 0 0 0 0 0 0 0 0 0 0 0 0 0 0 0 0 0 0 0 0 0 0 0 0 0 0 0 0 0 0 0 0 0 0 0 0 0 0
      0 0 0 0 0 0 0 0 0 0 0 0 0 0 0 0 0 0 0 0 0 0 0 0 0 0 0 0 0 0 0 0 0 0 0 0 0 0 0 0 0 0 0 0 0 0 0 0 0 0 0 0 0 0 0 0 0 0 0 0 0 0 0 0
      0 0 0 0 0 0 0 0 0 0 0 0 0 0 0 0 0 0 0 0 0 0 0 0 0 0 0 0 0 0 0 0 0 0 0 0 0 0 0 0 0 0 0 0 0 0 0 0 0 0 0 0 0 0 0 0 0 0 0 0 0 0 0 0
      0 0 0 0 0 0 0 0 0 0 0 0 0 0 0 0 0 0 0 0 0 0 0 0 0 0 0 0 0 0 0 0 0 0 0 0 0 0 0 0 0 0 0 0 0 0 0 0 0 0 0 0 0 0 0 0 0 0 0 0 0 0 0 0
      0 0 0 0 0 0 0 0 0 0 0 0 0 0 0 0 0 0 0 0 0 0 0 0 0 0 0 0 0 0 0 0 0 0 0 0 0 0 0 0 0 0 0 0 0 0 0 0 0 0 0 0 0 0 0 0 0 0 0 0 0 0 0 0
      0 0 0 0 0 0 0 0 0 0 0 0 0 0 0 0 0 0 0 0 0 0 0 0 0 0 0 0 0 0 0 0 0 0 0 0 0 0 0 0 0 0 0 0 0 0 0 0 0 0 0 0 0 0 0 0 0 0 0 0 0 0 0 0
      0 0 0 0 0 0 0 0 0 0 0 0 0 0 0 0 0 0 0 0 0 0 0 0 0 0 0 0 0 0 0 0 0 0 0 0 0 0 0 0 0 0 0 0 0 0 0 0 0 0 0 0 0 0 0 0 0 0 0 0 0 0 0 0
      0 0 0 0 0 0 0 0 0 0 0 0 0 0 0 0 0 0 0 0 0 0 0 0 0 0 0 0 0 0 0 0 0 0 0 0 0 0 0 0 0 0 0 0 0 0 0 0 0 0 0 0 0 0 0 0 0 0 0 0 0 0 0 0
      0 0 0 0 0 0 0 0 0 0 0 0 0 0 0 0 0 0 0 0 0 0 0 0 0 0 0 0 0 0 0 0 0 0 0 0 0 0 0 0 0 0 0 0 0 0 0 0 0 0 0 0 0 0 0 0 0 0 0 0 0 0 0 0
      0 0 0 0 0 0 0 0 0 0 0 0 0 0 0 0 0 0 0 0 0 0 0 0 0 0 0 0 0 0 0 0 0 0 0 0 0 0 0 0 0 0 0 0 0 0 0 0 0 0 0 0 0 0 0 0 0 0 0 0 0 0 0 0
      0 0 0 0 0 0 0 0 0 0 0 0 0 0 0 0 0 0 0 0 0 0 0 0 0 0 0 0 0 0 0 0 0 0 0 0 0 0 0 0 0 0 0 0 0 0 0 0 0 0 0 0 0 0 0 0 0 0 0 0 0 0 0 0
      0 0 0 0 0 0 0 0 0 0 0 0 0 0 0 0 0 0 0 0 0 0 0 0 0 0 0 0 0 0 0 0 0 0 0 0 0 0 0 0 0 0 0 0 0 0 0 0 0 0 0 0 0 0 0 0 0 0 0 0 0 0 0 0
      0 0 0 0 0 0 0 0 0 0 0 0 0 0 0 0 0 0 0 0 0 0 0 0 0 0 0 0 0 0 0 0 0 0 0 0 0 0 0 0 0 0 0 0 0 0 0 0 0 0 0 0 0 0 0 0 0 0 0 0 0 0 0 0
      0 0 0 0 0 0 0 0 0 0 0 0 0 0 0 0 0 0 0 0 0 0 0 0 0 0 0 0 0 0 0 0 0 0 0 0 0 0 0 0 0 0 0 0 0 0 0 0 0 0 0 0 0 0 0 0 0 0 0 0 0 0 0 0
      0 0 0 0 0 0 0 0 0 0 0 0 0 0 0 0 0 0 0 0 0 0 0 0 0 0 0 0 0 0 0 0 0 0 0 0 0 0 0 0 0 0 0 0 0 0 0 0 0 0 0 0 0 0 0 0 0 0 0 0 0 0 0 0
      0 0 0 0 0 0 0 0 0 0 0 0 0 0 0 0 0 0 0 0 0 0 0 0 0 0 0 0 0 0 0 0 0 0 0 0 0 0 0 0 0 0 0 0 0 0 0 0 0 0 0 0 0 0 0 0 0 0 0 0 0 0 0 0
      0 0 0 0 0 0 0 0 0 0 0 0 0 0 0 0 0 0 0 0 0 0 0 0 0 0 0 0 0 0 0 0 0 0 0 0 0 0 0 0 0 0 0 0 0 0 0 0 0 0 0 0 0 0 0 0 0 0 0 0 0 0 0 0
      0 0 0 0 0 0 0 0 0 0 0 0 0 0 0 0 0 0 0 0 0 0 0 0 0 0 0 0 0 0 0 0 0 0 0 0 0 0 0 0 0 0 0 0 0 0 0 0 0 0 0 0 0 0 0 0 0 0 0 0 0 0 0 0
      )
    )
    (lantern
      (x 540)
      (y 348)
      (color 0 0 0)
    )
    (camera
      (mode "normal")
    )
  )
)
