(tuxjunior-level
  (version 2)
  (name (_ "Trees Suck"))
  (author "SuperTux Team")
  (sector
    (name "main")
    (music "music/treeboss.music")
    (ambient-light 0.5333334 0.5333334 0.5333334)
    (spawnpoint
      (name "main")
      (x 160)
      (y 896)
    )
    (lantern
      (x 540)
      (y 348)
      (color 0 0 0)
    )
    (lantern
      (x 940)
      (y 248)
      (color 0 0 0)
    )
    (lantern
      (x 1040)
      (y 148)
      (color 0 0 0)
    )
    (platform
      (name "platform1")
      (running #f)
      (sprite "images/objects/flying_platform/flying_platform.sprite")
      (path
        (node
          (x 128)
          (y 992)
          (time 2)
        )
        (node
          (x 128)
          (y 416)
        )
      )
    )
    (scripttrigger
      (script "platform1.goto_node(1);")
      (button #f)
      (width 124)
      (height 32)
      (x 128)
      (y 960)
    )
    (background
      (speed 0.5)
      (image "images/background/arctis_dark.jpg")
    )
    (tilemap
      (z-pos -100)
      (solid #f)
      (name "Background")
      (speed 1)
      (width 50)
      (height 35)
      (tiles
      1958 1958 1958 1958 1958 1958 1958 1958 1958 1958 1958 1958 1958 1958 1958 1958 1958 1958 1958 1958 1958 1958 1958 1958 1958 1958 1958 1958 1958 1958 1958 1958 1958 1958 1958 1958 1958 1958 1958 1958 1958 1958 1958 1958 1958 1958 1958 1958 1958 1958
      1958 1958 1958 1958 1958 1958 1958 1958 1958 1958 1958 1958 1958 1958 1958 1958 1958 1958 1958 1958 1958 1958 1958 1958 1958 1958 1958 1958 1958 1958 1958 1958 1958 1958 1958 1958 1958 1958 1958 1958 1958 1958 1958 1958 1958 1958 1958 1958 1958 1958
      1958 1958 1958 1958 1958 1958 1958 1958 1958 1958 1958 1958 1958 1958 1958 1958 1958 1958 1958 1958 1958 1958 1958 1958 1958 1958 1958 1958 1958 1958 1958 1958 1958 1958 1958 1958 1958 1958 1958 1958 1958 1958 1958 1958 1958 1958 1958 1958 1958 1958
      1958 1958 1958 1958 1958 1958 1958 1958 1958 1958 1958 1958 1958 1958 1958 1958 1958 1958 1958 1958 1958 1958 1958 1958 1958 1958 1958 1958 1958 1958 1958 1958 1958 1958 1958 1958 1958 1958 1958 1958 1958 1958 1958 1958 1958 1958 1958 1958 1958 1958
      1958 1958 1958 1958 1958 1958 1958 1958 1958 1958 1958 1958 1958 1958 1958 1958 1958 1958 1958 1958 1958 1958 1958 1958 1958 1958 1958 1958 1958 1958 1958 1958 1958 1958 1958 1958 1958 1958 1958 1958 1958 1958 1958 1958 1958 1958 1958 1958 1958 1958
      1958 1958 1958 1958 1958 1958 1958 1958 1958 1958 1958 1958 1958 1958 1958 1958 1958 1958 1958 1958 1958 1958 1958 1958 1958 1958 1958 1958 1958 1958 1958 1958 1958 1958 1958 1958 1958 1958 1958 1958 1958 1958 1958 1958 1958 1958 1958 1958 1958 1958
      1958 1958 1958 1958 1958 1958 1958 1958 1958 1958 1958 1958 1958 1958 1958 1958 1958 1958 1958 1958 1958 1958 1958 1958 1958 1958 1958 1958 1958 1958 1958 1958 1958 1958 1958 1958 1958 1958 1958 1958 1958 1958 1958 1958 1958 1958 1958 1958 1958 1958
      1958 1958 1958 1958 1958 1958 1958 1958 1958 1958 1958 1958 1958 1958 1958 1958 1958 1958 1958 1958 1958 1958 1958 1958 1958 1958 1958 1958 1958 1958 1958 1958 1958 1958 1958 1958 1958 1958 1958 1958 1958 1958 1958 1958 1958 1958 1958 1958 1958 1958
      1958 1958 1958 1958 1958 1958 1958 1958 1958 1958 1958 1958 1958 1958 1958 1958 1958 1958 1958 1958 1958 1958 1958 1958 1958 1958 1958 1958 1958 1958 1958 1958 1958 1958 1958 1958 1958 1958 1958 1958 1958 1958 1958 1958 1958 1958 1958 1958 1958 1958
      1958 1958 1958 1958 1958 1958 1958 1958 1958 1958 1958 1958 1958 1958 1958 1958 1958 1958 1958 1958 1958 1958 1958 1958 1958 1958 1958 1958 1958 1958 1958 1958 1958 1958 1958 1958 1958 1958 1958 1958 1958 1958 1958 1958 1958 1958 1958 1958 1958 1958
      1958 1958 1958 1958 1958 1958 1958 1958 1958 1958 1958 1958 1958 1958 1958 1958 1958 1958 1958 1958 1958 1958 1958 1958 1958 1958 1958 1958 1958 1958 1958 1958 1958 1958 1958 1958 1958 1958 1958 1958 1958 1958 1958 1958 1958 1958 1958 1958 1958 1958
      1956 1957 1958 1958 1958 1958 1958 1958 1959 1956 1957 1958 1959 1958 1958 1958 1958 1958 1958 1958 1958 1958 1958 1958 1958 1958 1958 1958 1958 1958 1958 1958 1959 1956 1957 1958 1959 1958 1958 1958 1958 1958 1958 1958 1958 1958 1958 1959 1956 1957
      1960 1961 1958 1959 1956 1957 1958 1959 1963 1960 1961 1962 1963 1959 1956 1957 1958 1959 1958 1958 1958 1958 1959 1956 1957 1958 1959 1958 1958 1958 1958 1958 1959 1956 1957 1958 1959 1959 1956 1957 1958 1959 1959 1956 1957 1958 1959 1963 1960 1961
      1964 1965 1962 1963 1960 1961 1962 1963 1967 1964 1965 1966 1967 1963 1960 1961 1962 1963 1959 1956 1957 1958 1963 1960 1961 1962 1963 1959 1956 1957 1958 1959 1963 1960 1961 1962 1963 1963 1960 1961 1962 1963 1963 1960 1961 1962 1963 1967 1964 1965
      1968 1969 1966 1967 1964 1965 1966 1967 1971 1968 1969 1970 1971 1967 1964 1965 1966 1967 1963 1960 1961 1962 1967 1964 1965 1966 1967 1963 1960 1961 1962 1963 1967 1964 1965 1966 1967 1967 1964 1965 1966 1967 1967 1964 1965 1966 1967 1971 1968 1969
      1917 1917 1970 1971 1968 1969 1970 1971 1917 1917 1917 1917 1917 1971 1968 1969 1970 1971 1967 1964 1965 1966 1971 1968 1969 1970 1971 1967 1964 1965 1966 1967 1971 1968 1969 1970 1971 1971 1968 1969 1970 1971 1971 1968 1969 1970 1971 1917 1917 1917
      1917 1917 1917 1917 1918 1919 1916 1917 1917 1917 1917 1917 1917 1917 1917 1917 1918 1919 1971 1968 1969 1970 1971 1917 1917 1917 1917 1971 1968 1969 1970 1971 1917 1917 1917 1917 1918 1919 1916 1917 1922 1923 1920 1921 1917 1917 1917 1917 1917 1917
      1918 1919 1916 1917 1922 1923 1920 1921 1918 1919 1916 1917 1918 1919 1916 1917 1922 1923 1920 1921 1918 1919 1916 1917 1918 1919 1916 1917 1926 1927 1924 1925 1918 1919 1916 1917 1922 1923 1920 1921 1926 1927 1924 1925 1918 1919 1916 1917 1918 1919
      1922 1923 1920 1921 1926 1927 1924 1925 1922 1923 1920 1921 1922 1923 1920 1921 1926 1927 1924 1925 1922 1923 1920 1921 1922 1923 1920 1921 1930 1931 1928 1929 1922 1923 1920 1921 1926 1927 1924 1925 1930 1931 1928 1929 1922 1923 1920 1921 1922 1923
      1926 1927 1924 1925 1930 1931 1928 1929 1926 1927 1924 1925 1926 1927 1924 1925 1930 1931 1928 1929 1926 1927 1924 1925 1926 1927 1924 1925 1934 1935 1932 1933 1926 1927 1924 1925 1930 1931 1928 1929 1934 1935 1932 1933 1926 1927 1924 1925 1926 1927
      1930 1931 1928 1929 1934 1935 1932 1933 1930 1931 1928 1929 1930 1931 1928 1929 1934 1935 1932 1933 1930 1931 1928 1929 1930 1931 1928 1929 1932 1932 1932 1932 1930 1931 1928 1929 1934 1935 1932 1933 1932 1932 1932 1932 1930 1931 1928 1929 1930 1931
      1934 1935 1932 1933 1932 1932 1932 1932 1934 1935 1932 1933 1934 1935 1932 1933 1932 1932 1932 1932 1934 1935 1932 1933 1934 1935 1932 1933 1932 1932 1932 1932 1934 1935 1932 1933 1932 1932 1932 1932 1932 1932 1932 1932 1934 1935 1932 1933 1934 1935
      1932 1932 1932 1932 1932 1932 1932 1932 1932 1932 1932 1932 1932 1932 1932 1932 1932 1932 1932 1932 1932 1932 1932 1932 1932 1932 1932 1932 1932 1932 1932 1932 1932 1932 1932 1932 1932 1932 1932 1932 1932 1932 1932 1932 1932 1932 1932 1932 1932 1932
      1932 1932 1932 1932 1932 1932 1932 1932 1932 1932 1932 1932 1932 1932 1932 1932 1932 1932 1932 1932 1932 1932 1932 1932 1932 1932 1932 1932 1932 1932 1932 1932 1932 1932 1932 1932 1932 1932 1932 1932 1932 1932 1932 1932 1932 1932 1932 1932 1932 1932
      1932 1932 1932 1932 1932 1932 1932 1932 1932 1932 1932 1932 1932 1932 1932 1932 1932 1932 1932 1932 1932 1932 1932 1932 1932 1932 1932 1932 1932 1932 1932 1932 1932 1932 1932 1932 1932 1932 1932 1932 1932 1932 1932 1932 1932 1932 1932 1932 1932 1932
      1932 1932 1932 1932 1932 1932 1932 1932 1932 1932 1932 1932 1932 1932 1932 1932 1932 1932 1932 1932 1932 1932 1932 1932 1932 1932 1932 1932 1932 1932 1932 1932 1932 1932 1932 1932 1932 1932 1932 1932 1932 1932 1932 1932 1932 1932 1932 1932 1932 1932
      1932 1932 1932 1932 1932 1932 1932 1932 1932 1932 1932 1932 1932 1932 1932 1932 1932 1932 1932 1932 1932 1932 1932 1932 1932 1932 1932 1932 1932 1932 1932 1932 1932 1932 1932 1932 1932 1932 1932 1932 1932 1932 1932 1932 1932 1932 1932 1932 1932 1932
      1932 1932 1932 1932 1932 1932 1932 1932 1932 1932 1932 1932 1932 1932 1932 1932 1932 1932 1932 1932 1932 1932 1932 1932 1932 1932 1932 1932 1932 1932 1932 1932 1932 1932 1932 1932 1932 1932 1932 1932 1932 1932 1932 1932 1932 1932 1932 1932 1932 1932
      1932 1932 1932 1932 1932 1932 1932 1932 1932 1932 1932 1932 1932 1932 1932 1932 1932 1932 1932 1932 1932 1932 1932 1932 1932 1932 1932 1932 1932 1932 1932 1932 1932 1932 1932 1932 1932 1932 1932 1932 1932 1932 1932 1932 1932 1932 1932 1932 1932 1932
      1932 1932 1932 1932 1932 1932 1932 1932 1932 1932 1932 1932 1932 1932 1932 1932 1932 1932 1932 1932 1932 1932 1932 1932 1932 1932 1932 1932 1932 1932 1932 1932 1932 1932 1932 1932 1932 1932 1932 1932 1932 1932 1932 1932 1932 1932 1932 1932 1932 1932
      1932 1932 1932 1932 1932 1932 1932 1932 1932 1932 1932 1932 1932 1932 1932 1932 1932 1932 1932 1932 1932 1932 1932 1932 1932 1932 1932 1932 1932 1932 1932 1932 1932 1932 1932 1932 1932 1932 1932 1932 1932 1932 1932 1932 1932 1932 1932 1932 1932 1932
      1932 1932 1932 1932 1932 1932 1932 1932 1932 1932 1932 1932 1932 1932 1932 1932 1932 1932 1932 1932 1932 1932 1932 1932 1932 1932 1932 1932 1932 1932 1932 1932 1932 1932 1932 1932 1932 1932 1932 1932 1932 1932 1932 1932 1932 1932 1932 1932 1932 1932
      1932 1932 1932 1932 1932 1932 1932 1932 1932 1932 1932 1932 1932 1932 1932 1932 1932 1932 1932 1932 1932 1932 1932 1932 1932 1932 1932 1932 1932 1932 1932 1932 1932 1932 1932 1932 1932 1932 1932 1932 1932 1932 1932 1932 1932 1932 1932 1932 1932 1932
      1932 1932 1932 1932 1932 1932 1932 1932 1932 1932 1932 1932 1932 1932 1932 1932 1932 1932 1932 1932 1932 1932 1932 1932 1932 1932 1932 1932 1932 1932 1932 1932 1932 1932 1932 1932 1932 1932 1932 1932 1932 1932 1932 1932 1932 1932 1932 1932 1932 1932
      1932 1932 1932 1932 1932 1932 1932 1932 1932 1932 1932 1932 1932 1932 1932 1932 1932 1932 1932 1932 1932 1932 1932 1932 1932 1932 1932 1932 1932 1932 1932 1932 1932 1932 1932 1932 1932 1932 1932 1932 1932 1932 1932 1932 1932 1932 1932 1932 1932 1932
      )
    )
    (tilemap
      (z-pos 0)
      (solid #t)
      (name "Interactive")
      (speed 1)
      (width 50)
      (height 35)
      (tiles
      1869 1869 1869 1869 1869 1869 1869 1869 1869 1869 1869 1869 1869 1869 1869 1869 1869 1869 1869 1869 1869 1869 1869 1869 1869 1869 1869 1869 1869 1869 1869 1869 1869 1869 1869 1869 1869 1869 1869 1869 1869 1869 1869 1869 1869 1869 1869 1869 1869 1869
      1869 1869 1869 1869 1869 1869 1869 1869 1869 1869 1869 1869 1869 1869 1869 1869 1869 1869 1869 1869 1869 1869 1869 1869 1869 1869 1869 1869 1869 1869 1869 1869 1869 1869 1869 1869 1869 1869 1869 1869 1869 1869 1869 1869 1869 1869 1869 1869 1869 1869
      1869 1869 1869 1877 1879 1877 1879 1877 1879 1877 1879 1877 1879 1877 1879 1877 1879 1877 1879 1877 1879 1877 1879 1877 1879 1877 1879 1877 1879 1877 1879 1877 1879 1877 1879 1877 1879 1877 1879 1877 1879 1877 1879 1877 1879 1877 1879 1869 1869 1869
      1869 1869 1875 0 0 0 0 0 0 0 0 0 0 0 0 0 0 0 0 0 0 0 0 0 0 0 0 0 0 0 0 0 0 0 0 0 0 0 0 0 0 0 0 0 0 0 0 1872 1869 1869
      1869 1869 1875 0 0 0 0 0 0 0 0 0 0 0 0 0 0 0 0 0 0 0 0 0 0 0 0 0 0 0 0 0 0 0 0 0 0 0 0 0 0 0 0 0 0 0 0 1872 1869 1869
      1869 1869 1875 0 0 0 0 0 0 0 0 0 0 0 0 0 0 0 0 0 0 0 0 0 0 0 0 0 0 0 0 0 0 0 0 0 0 0 0 0 0 0 0 0 0 0 0 1872 1869 1869
      1869 1869 1875 0 0 0 0 0 0 0 0 0 0 0 0 0 0 0 0 0 0 0 0 0 0 0 0 0 0 0 0 0 0 0 0 0 0 0 0 0 0 0 0 0 0 0 0 1872 1869 1869
      1869 1869 1875 0 0 0 0 0 0 0 0 0 0 0 0 0 0 0 0 0 0 0 0 1551 1540 1540 1541 0 0 0 0 0 0 0 0 0 0 0 0 0 0 0 0 0 0 0 0 1872 1869 1869
      1869 1869 1875 0 0 0 0 0 0 0 0 0 0 0 0 0 0 0 0 0 0 0 0 0 0 0 0 0 0 0 0 0 0 0 0 0 0 0 0 0 0 0 0 0 0 0 0 1872 1869 1869
      1869 1869 1875 0 0 0 0 0 0 0 0 0 0 0 0 0 0 0 0 0 0 0 0 0 0 0 0 0 0 0 0 0 0 0 0 0 0 0 0 0 0 0 0 0 0 0 0 1872 1869 1869
      1869 1869 1875 0 0 0 0 0 0 0 0 0 0 0 1551 1540 1541 0 0 0 0 0 0 0 0 0 0 0 0 0 0 0 0 1551 1540 1541 0 0 0 0 0 0 0 0 0 0 0 1872 1869 1869
      1869 1869 1875 0 0 0 0 0 0 0 0 0 0 0 0 0 0 0 0 0 0 0 0 0 0 0 0 0 0 0 0 0 0 0 0 0 0 0 0 0 0 0 0 0 0 0 0 1872 1869 1869
      1869 1869 1875 0 0 0 0 0 0 0 0 0 0 0 0 0 0 0 0 0 0 0 0 0 0 0 0 0 0 0 0 0 0 0 0 0 0 0 0 0 0 0 0 0 0 0 0 1872 1869 1869
      1869 1869 1875 0 0 0 0 0 1551 1540 1541 0 0 0 0 0 0 0 0 0 0 0 0 0 0 0 0 0 0 0 0 0 0 0 0 0 0 0 0 1408 1412 1388 0 0 0 0 0 1872 1869 1869
      1869 1869 1875 0 0 0 0 0 0 0 0 0 0 0 0 0 0 0 0 0 0 0 0 0 0 0 0 0 0 0 0 0 0 0 0 0 0 0 0 0 0 0 0 0 0 0 0 1872 1869 1869
      1869 1869 1875 0 0 0 0 0 0 0 0 0 0 0 0 0 0 0 0 0 0 0 0 0 0 0 0 0 0 0 0 0 0 0 0 0 0 0 0 0 0 0 0 0 0 0 0 1872 1869 1869
      1869 1869 1875 0 0 0 0 0 0 0 0 0 0 0 0 0 0 0 0 0 0 0 0 0 0 0 0 0 0 0 0 0 0 0 0 0 0 0 0 0 0 0 0 0 0 0 0 1872 1869 1869
      1869 1869 1875 0 0 0 0 0 0 0 0 0 0 1551 1540 1541 0 0 0 0 0 0 0 0 0 0 0 0 0 0 0 0 0 0 1551 1540 1541 0 0 0 0 0 0 0 0 0 0 1872 1869 1869
      1869 1869 1875 0 0 0 0 0 0 0 0 0 0 0 0 0 0 0 0 0 0 0 0 0 0 0 0 0 0 0 0 0 0 0 0 0 0 0 0 0 0 0 0 0 0 0 0 1872 1869 1869
      1869 1869 1875 0 0 0 0 0 0 0 0 0 0 0 0 0 0 0 0 0 0 0 0 0 0 0 0 0 0 0 0 0 0 0 0 0 0 0 0 0 0 0 0 0 0 0 0 1872 1869 1869
      1869 1869 1875 0 0 0 0 0 0 0 0 0 0 0 0 0 0 0 0 0 0 0 0 0 0 0 0 0 0 0 0 0 0 0 0 0 0 0 0 0 0 0 0 0 0 0 0 1872 1869 1869
      1869 1869 1869 1867 0 0 0 0 1864 1865 1866 1866 1865 1866 1865 1866 1865 1866 1865 1866 1865 1866 1865 1866 1865 1866 1865 1866 1865 1866 1865 1866 1865 1866 1865 1866 1865 1866 1865 1866 1865 1866 1865 1866 1865 1865 1866 1865 1869 1869
      1869 1869 1869 1871 0 0 0 0 1868 1869 1870 1870 1869 1870 1869 1870 1869 1870 1869 1870 1869 1870 1869 1870 1869 1870 1869 1870 1869 1870 1869 1870 1869 1870 1869 1870 1869 1870 1869 1870 1869 1870 1869 1870 1869 1870 1870 1870 1869 1873
      1869 1869 1869 1875 0 0 0 0 1872 1869 1870 1869 1870 1869 1870 1869 1870 1869 1870 1869 1870 1869 1870 1869 1870 1869 1870 1869 1870 1869 1870 1869 1870 1869 1870 1869 1870 1869 1870 1869 1870 1869 1870 1869 1870 1869 1870 1869 1870 1869
      1869 1869 1869 1875 0 0 0 0 1872 1873 1874 1873 1874 1873 1874 1873 1874 1873 1874 1873 1874 1873 1874 1873 1874 1873 1874 1873 1874 1873 1874 1873 1874 1873 1874 1873 1874 1873 1874 1873 1874 1873 1874 1873 1874 1873 1874 1873 1874 1869
      1869 1869 1869 1875 0 0 0 0 1872 1869 1870 1869 1870 1869 1870 1869 1870 1869 1870 1869 1870 1869 1870 1869 1870 1869 1870 1869 1870 1869 1869 1869 1869 1869 1869 1869 1869 1869 1869 1869 1869 1869 1869 1869 1869 1869 1869 1869 1869 1869
      1869 1869 1869 1875 0 0 0 0 1872 1873 1874 1873 1874 1873 1874 1873 1874 1873 1874 1873 1874 1873 1874 1873 1874 1873 1874 1873 1874 1869 1869 1869 1869 1869 1869 1869 1869 1869 1869 1869 1869 1869 1869 1869 1869 1869 1869 1869 1869 1869
      1869 1869 1869 1875 0 0 0 0 1872 1869 1870 1869 1870 1869 1870 1869 1870 1869 1870 1869 1870 1869 1870 1869 1870 1869 1870 1869 1870 1869 1869 1869 1869 1869 1869 1869 1869 1869 1869 1869 1869 1869 1870 1869 1870 1869 1869 1869 1869 1869
      1869 1869 1869 1875 0 0 0 0 1872 1873 1874 1873 1874 1873 1874 1873 1874 1873 1874 1873 1874 1873 1874 1873 1874 1873 1874 1873 1874 1869 1869 1869 1869 1869 1869 1869 1869 1869 1869 1869 1869 1873 1874 1873 1874 1869 1869 1869 1869 1869
      1869 1869 1869 1875 0 0 0 0 1872 1869 1870 1869 1870 1869 1870 1869 1870 1869 1870 1869 1870 1869 1870 1869 1870 1869 1870 1869 1870 1869 1870 1869 1869 1869 1869 1869 1870 1869 1869 1869 1869 1869 1869 1869 1869 1869 1869 1869 1870 1869
      1869 1869 1869 1875 0 0 0 0 1872 1873 1874 1873 1874 1873 1874 1873 1874 1873 1874 1873 1874 1873 1874 1873 1874 1873 1874 1873 1874 1873 1874 1869 1869 1869 1869 1873 1874 1869 1869 1869 1869 1869 1869 1869 1869 1869 1869 1873 1874 1869
      1869 1869 1869 1875 0 0 0 0 1872 1869 1870 1869 1870 1869 1870 1869 1870 1869 1870 1869 1870 1869 1870 1869 1870 1869 1870 1869 1870 1869 1870 1869 1869 1869 1869 1869 1869 1869 1869 1869 1870 1869 1869 1869 1869 1869 1869 1869 1870 1869
      1869 1869 1869 1875 0 0 0 0 1872 1873 1874 1873 1874 1873 1874 1873 1874 1873 1874 1873 1874 1873 1874 1873 1874 1873 1874 1873 1874 1873 1874 1869 1869 1869 1869 1869 1869 1869 1869 1873 1874 1869 1869 1869 1869 1869 1869 1873 1874 1869
      1869 1869 1869 1875 0 0 0 0 1872 1869 1870 1869 1870 1869 1870 1869 1870 1869 1870 1869 1870 1869 1870 1869 1870 1869 1870 1869 1870 1869 1870 1869 1870 1869 1870 1869 1870 1869 1870 1869 1870 1869 1870 1869 1870 1869 1870 1869 1870 1869
      1869 1869 1869 1875 0 0 0 0 1872 1873 1874 1873 1874 1873 1874 1873 1874 1873 1874 1873 1874 1873 1874 1873 1874 1873 1874 1873 1874 1873 1874 1873 1874 1873 1874 1873 1874 1873 1874 1873 1874 1873 1874 1873 1874 1873 1874 1873 1874 1869
      )
    )
    (tilemap
      (z-pos 100)
      (solid #f)
      (name "Foreground")
      (speed 1)
      (width 50)
      (height 35)
      (tiles
      0 0 0 0 0 0 0 0 0 0 0 0 0 0 0 0 0 0 0 0 0 0 0 0 0 0 0 0 0 0 0 0 0 0 0 0 0 0 0 0 0 0 0 0 0 0 0 0 0 0
      0 0 0 0 0 0 0 0 0 0 0 0 0 0 0 0 0 0 0 0 0 0 0 0 0 0 0 0 0 0 0 0 0 0 0 0 0 0 0 0 0 0 0 0 0 0 0 0 0 0
      0 0 0 0 0 0 0 0 0 0 0 0 0 0 0 0 0 0 0 0 0 0 0 0 0 0 0 0 0 0 0 0 0 0 0 0 0 0 0 0 0 0 0 0 0 0 0 0 0 0
      0 0 0 0 0 0 0 0 0 0 0 0 0 0 0 0 0 0 0 0 0 0 0 0 0 0 0 0 0 0 0 0 0 0 0 0 0 0 0 0 0 0 0 0 0 0 0 0 0 0
      0 0 0 0 0 0 0 0 0 0 0 0 0 0 0 0 0 0 0 0 0 0 0 0 0 0 0 0 0 0 0 0 0 0 0 0 0 0 0 0 0 0 0 0 0 0 0 0 0 0
      0 0 0 0 0 0 0 0 0 0 0 0 0 0 0 0 0 0 0 0 0 0 0 0 0 0 0 0 0 0 0 0 0 0 0 0 0 0 0 0 0 0 0 0 0 0 0 0 0 0
      0 0 0 0 0 0 0 0 0 0 0 0 0 0 0 0 0 0 0 0 0 0 0 0 0 0 0 0 0 0 0 0 0 0 0 0 0 0 0 0 0 0 0 0 0 0 0 0 0 0
      0 0 0 0 0 0 0 0 0 0 0 0 0 0 0 0 0 0 0 0 0 0 0 0 0 0 0 0 0 0 0 0 0 0 0 0 0 0 0 0 0 0 0 0 0 0 0 0 0 0
      0 0 0 0 0 0 0 0 0 0 0 0 0 0 0 0 0 0 0 0 0 0 0 0 0 0 0 0 0 0 0 0 0 0 0 0 0 0 0 0 0 0 0 0 0 0 0 0 0 0
      0 0 0 0 0 0 0 0 0 0 0 0 0 0 0 0 0 0 0 0 0 0 0 0 0 0 0 0 0 0 0 0 0 0 0 0 0 0 0 0 0 0 0 0 0 0 0 0 0 0
      0 0 0 0 0 0 0 0 0 0 0 0 0 0 0 0 0 0 0 0 0 0 0 0 0 0 0 0 0 0 0 0 0 0 0 0 0 0 0 0 0 0 0 0 0 0 0 0 0 0
      0 0 0 0 0 0 0 0 0 0 0 0 0 0 0 0 0 0 0 0 0 0 0 0 0 0 0 0 0 0 0 0 0 0 0 0 0 0 0 0 0 0 0 0 0 0 0 0 0 0
      0 0 0 0 0 0 0 0 0 0 0 0 0 0 0 0 0 0 0 0 0 0 0 0 0 0 0 0 0 0 0 0 0 0 0 0 0 0 0 0 0 0 0 0 0 0 0 0 0 0
      0 0 0 0 0 0 0 0 0 0 0 0 0 0 0 0 0 0 0 0 0 0 0 0 0 0 0 0 0 0 0 0 0 0 0 0 0 0 0 0 0 0 0 0 0 0 0 0 0 0
      0 0 0 0 0 0 0 0 0 0 0 0 0 0 0 0 0 0 0 0 0 0 0 0 0 0 0 0 0 0 0 0 0 0 0 0 0 0 0 0 0 0 0 0 0 0 0 0 0 0
      0 0 0 0 0 0 0 0 0 0 0 0 0 0 0 0 0 0 0 0 0 0 0 0 0 0 0 0 0 0 0 0 0 0 0 0 0 0 0 0 0 0 0 0 0 0 0 0 0 0
      0 0 0 0 0 0 0 0 0 0 0 0 0 0 0 0 0 0 0 0 0 0 0 0 0 0 0 0 0 0 0 0 0 0 0 0 0 0 0 0 0 0 0 0 0 0 0 0 0 0
      0 0 0 0 0 0 0 0 0 0 0 0 0 0 0 0 0 0 0 0 0 0 0 0 0 0 0 0 0 0 0 0 0 0 0 0 0 0 0 0 0 0 0 0 0 0 0 0 0 0
      0 0 0 0 0 0 0 0 0 0 0 0 0 0 0 0 0 0 0 0 0 0 0 0 0 0 0 0 0 0 0 0 0 0 0 0 0 0 0 0 0 0 0 0 0 0 0 0 0 0
      0 0 0 0 0 0 0 0 0 0 0 0 0 0 0 0 0 0 0 0 0 0 0 0 0 0 0 0 0 0 0 0 0 0 0 0 0 0 0 0 0 0 0 0 0 0 0 0 0 0
      0 0 0 0 0 0 0 0 0 0 0 0 0 0 0 0 0 0 0 0 0 0 0 0 0 0 0 0 0 0 0 0 0 0 0 0 0 0 0 0 0 0 0 0 0 0 0 0 0 0
      0 0 0 0 0 0 0 0 0 0 0 0 0 0 0 0 0 0 0 0 0 0 0 0 0 0 0 0 0 0 0 0 0 0 0 0 0 0 0 0 0 0 0 0 0 0 0 0 0 0
      0 0 0 0 0 0 0 0 0 0 0 0 0 0 0 0 0 0 0 0 0 0 0 0 0 0 0 0 0 0 0 0 0 0 0 0 0 0 0 0 0 0 0 0 0 0 0 0 0 0
      0 0 0 0 0 0 0 0 0 0 0 0 0 0 0 0 0 0 0 0 0 0 0 0 0 0 0 0 0 0 0 0 0 0 0 0 0 0 0 0 0 0 0 0 0 0 0 0 0 0
      0 0 0 0 0 0 0 0 0 0 0 0 0 0 0 0 0 0 0 0 0 0 0 0 0 0 0 0 0 0 0 0 0 0 0 0 0 0 0 0 0 0 0 0 0 0 0 0 0 0
      0 0 0 0 0 0 0 0 0 0 0 0 0 0 0 0 0 0 0 0 0 0 0 0 0 0 0 0 0 0 0 0 0 0 0 0 0 0 0 0 0 0 0 0 0 0 0 0 0 0
      0 0 0 0 0 0 0 0 0 0 0 0 0 0 0 0 0 0 0 0 0 0 0 0 0 0 0 0 0 0 0 0 0 0 0 0 0 0 0 0 0 0 0 0 0 0 0 0 0 0
      0 0 0 0 0 0 0 0 0 0 0 0 0 0 0 0 0 0 0 0 0 0 0 0 0 0 0 0 0 0 0 0 0 0 0 0 0 0 0 0 0 0 0 0 0 0 0 0 0 0
      0 0 0 0 0 0 0 0 0 0 0 0 0 0 0 0 0 0 0 0 0 0 0 0 0 0 0 0 0 0 0 0 0 0 0 0 0 0 0 0 0 0 0 0 0 0 0 0 0 0
      0 0 0 0 0 0 0 0 0 0 0 0 0 0 0 0 0 0 0 0 0 0 0 0 0 0 0 0 0 0 0 0 0 0 0 0 0 0 0 0 0 0 0 0 0 0 0 0 0 0
      0 0 0 0 0 0 0 0 0 0 0 0 0 0 0 0 0 0 0 0 0 0 0 0 0 0 0 0 0 0 0 0 0 0 0 0 0 0 0 0 0 0 0 0 0 0 0 0 0 0
      0 0 0 0 0 0 0 0 0 0 0 0 0 0 0 0 0 0 0 0 0 0 0 0 0 0 0 0 0 0 0 0 0 0 0 0 0 0 0 0 0 0 0 0 0 0 0 0 0 0
      0 0 0 0 0 0 0 0 0 0 0 0 0 0 0 0 0 0 0 0 0 0 0 0 0 0 0 0 0 0 0 0 0 0 0 0 0 0 0 0 0 0 0 0 0 0 0 0 0 0
      0 0 0 0 0 0 0 0 0 0 0 0 0 0 0 0 0 0 0 0 0 0 0 0 0 0 0 0 0 0 0 0 0 0 0 0 0 0 0 0 0 0 0 0 0 0 0 0 0 0
      0 0 0 0 0 0 0 0 0 0 0 0 0 0 0 0 0 0 0 0 0 0 0 0 0 0 0 0 0 0 0 0 0 0 0 0 0 0 0 0 0 0 0 0 0 0 0 0 0 0
      )
    )
    (tilemap
      (z-pos -50)
      (solid #f)
      (name "Tree")
      (speed 1)
      (width 50)
      (height 35)
      (tiles
      0 0 0 0 0 0 0 0 0 0 0 0 0 0 0 0 0 0 0 0 0 0 0 0 0 0 0 0 0 0 0 0 0 0 0 0 0 0 0 0 0 0 0 0 0 0 0 0 0 0
      0 0 0 0 0 0 0 0 0 0 0 0 0 0 0 0 0 0 0 0 0 0 0 0 0 0 0 0 0 0 0 0 0 0 0 0 0 0 0 0 0 0 0 0 0 0 0 0 0 0
      0 0 0 0 0 0 0 0 0 0 0 0 0 0 0 0 0 0 0 0 0 0 0 0 0 0 0 0 0 0 0 0 0 0 0 0 0 0 0 0 0 0 0 0 0 0 0 0 0 0
      0 0 0 0 0 0 0 0 0 0 0 0 0 0 0 0 0 0 0 0 0 0 0 0 0 0 0 0 0 0 0 0 0 0 0 0 0 0 1110 0 0 0 0 0 0 0 0 0 0 0
      0 0 0 0 0 0 0 0 0 0 0 0 0 0 0 0 0 0 0 0 0 0 0 0 0 0 0 0 0 0 0 0 0 0 0 0 0 0 0 0 0 0 0 0 0 0 0 0 0 0
      0 0 0 0 0 0 0 0 0 0 0 0 0 0 0 0 0 0 0 0 0 0 0 0 0 0 0 0 0 0 0 0 0 0 0 0 0 0 0 0 0 0 0 0 0 0 0 0 0 0
      0 0 0 0 0 0 0 0 0 0 0 0 0 0 0 0 0 0 0 0 0 0 0 0 0 0 0 0 0 0 0 0 0 0 0 0 0 0 0 0 0 0 0 0 0 0 0 0 0 0
      0 0 0 0 0 0 0 0 0 0 0 0 0 0 0 0 0 0 0 0 0 0 0 0 0 0 0 0 0 0 0 0 0 0 0 0 0 0 0 0 0 0 0 0 0 0 0 0 0 0
      0 0 0 0 0 0 0 0 0 0 0 0 0 0 0 0 0 0 0 0 0 0 0 0 0 0 0 0 0 0 0 0 0 0 0 0 0 0 0 0 0 0 0 0 0 0 0 0 0 0
      0 0 0 0 0 0 0 0 0 0 0 0 0 0 0 0 0 0 0 0 0 0 0 0 0 0 0 0 0 0 0 0 0 0 0 0 0 0 0 0 0 0 0 0 0 0 0 0 0 0
      0 0 0 0 0 0 0 0 0 0 0 0 0 0 0 0 0 0 0 0 0 0 0 0 0 0 0 0 0 0 0 0 0 0 0 0 0 0 1134 0 0 0 0 0 0 0 0 0 0 0
      0 0 0 0 0 0 0 0 0 0 0 0 0 0 0 0 0 0 0 0 0 0 0 0 0 0 0 0 0 0 0 0 0 0 1126 0 0 0 0 0 0 0 0 0 0 0 0 0 0 0
      0 0 0 0 0 0 0 0 0 0 0 0 0 0 0 0 0 0 0 0 0 0 0 0 0 0 0 0 0 0 0 0 1148 0 0 0 0 0 0 0 0 0 0 0 0 0 0 0 0 0
      0 0 0 0 0 0 0 0 0 0 0 0 0 0 0 0 0 0 0 0 0 0 0 0 0 0 0 0 0 0 0 0 1148 0 0 0 0 0 0 0 0 0 0 0 0 0 0 0 0 0
      0 0 0 0 0 0 0 0 0 0 0 0 0 0 0 0 0 1145 0 0 0 0 0 0 0 0 0 0 0 0 0 0 1148 0 0 0 0 0 0 0 0 0 0 0 0 0 0 0 0 0
      0 0 0 0 0 0 0 0 0 0 0 0 0 0 0 0 0 1137 0 0 0 0 0 0 0 0 0 0 0 0 0 0 1140 0 0 0 0 0 0 0 0 0 0 0 0 0 0 0 0 0
      0 0 0 0 0 0 0 0 0 0 0 0 0 0 0 0 0 0 0 0 0 0 0 0 0 0 0 0 0 0 0 0 1148 0 0 0 0 0 0 0 0 0 0 0 0 0 0 0 0 0
      0 0 0 0 0 0 0 0 0 0 0 0 0 0 0 0 0 0 0 0 0 0 0 0 0 0 0 0 0 0 0 0 1140 0 0 0 0 0 0 0 0 0 0 0 0 0 0 0 0 0
      0 0 0 0 0 0 0 0 0 0 0 0 0 0 0 0 0 0 0 0 0 0 0 0 0 0 0 0 0 0 0 0 1148 0 0 0 0 0 0 0 0 0 0 0 0 0 0 0 0 0
      0 0 0 0 0 0 0 0 0 0 0 0 0 0 0 0 0 0 0 0 0 0 0 0 0 0 0 0 0 0 0 0 0 0 0 0 0 0 0 0 0 0 0 0 0 0 0 0 0 0
      0 0 0 0 0 0 0 0 1860 1861 1861 1862 1861 1862 1861 1862 1861 1862 1861 1862 1861 1862 1861 1862 1861 1862 1861 1862 1861 1862 1861 1862 1861 1862 1861 1862 1861 1862 1861 1862 1861 1862 1861 1862 1861 1862 0 0 0 0
      0 0 0 0 0 0 0 0 0 0 0 0 0 0 0 0 0 0 0 0 0 0 0 0 0 0 0 0 0 0 0 0 0 0 0 0 0 0 0 0 0 0 0 0 0 0 0 0 0 0
      0 0 0 0 0 0 0 0 0 0 0 0 0 0 0 0 0 0 0 0 0 0 0 0 0 0 0 0 0 0 0 0 0 0 0 0 0 0 0 0 0 0 0 0 0 0 0 0 0 0
      0 0 0 0 0 0 0 0 0 0 0 0 0 0 0 0 0 0 0 0 0 0 0 0 0 0 0 0 0 0 0 0 0 0 0 0 0 0 0 0 0 0 0 0 0 0 0 0 0 0
      0 0 0 0 0 0 0 0 0 0 0 0 0 0 0 0 0 0 0 0 0 0 0 0 0 0 0 0 0 0 0 0 0 0 0 0 0 0 0 0 0 0 0 0 0 0 0 0 0 0
      0 0 0 0 0 0 0 0 0 0 0 0 0 0 0 0 0 0 0 0 0 0 0 0 0 0 0 0 0 0 0 0 0 0 0 0 0 0 0 0 0 0 0 0 0 0 0 0 0 0
      0 0 0 0 0 0 0 0 0 0 0 0 0 0 0 0 0 0 0 0 0 0 0 0 0 0 0 0 0 0 0 0 0 0 0 0 0 0 0 0 0 0 0 0 0 0 0 0 0 0
      0 0 0 0 0 0 0 0 0 0 0 0 0 0 0 0 0 0 0 0 0 0 0 0 0 0 0 0 0 0 0 0 0 0 0 0 0 0 0 0 0 0 0 0 0 0 0 0 0 0
      0 0 0 0 0 0 0 0 0 0 0 0 0 0 0 0 0 0 0 0 0 0 0 0 0 0 0 0 0 0 0 0 0 0 0 0 0 0 0 0 0 0 0 0 0 0 0 0 0 0
      0 0 0 0 0 0 0 0 0 0 0 0 0 0 0 0 0 0 0 0 0 0 0 0 0 0 0 0 0 0 0 0 0 0 0 0 0 0 0 0 0 0 0 0 0 0 0 0 0 0
      0 0 0 0 0 0 0 0 0 0 0 0 0 0 0 0 0 0 0 0 0 0 0 0 0 0 0 0 0 0 0 0 0 0 0 0 0 0 0 0 0 0 0 0 0 0 0 0 0 0
      0 0 0 0 0 0 0 0 0 0 0 0 0 0 0 0 0 0 0 0 0 0 0 0 0 0 0 0 0 0 0 0 0 0 0 0 0 0 0 0 0 0 0 0 0 0 0 0 0 0
      0 0 0 0 0 0 0 0 0 0 0 0 0 0 0 0 0 0 0 0 0 0 0 0 0 0 0 0 0 0 0 0 0 0 0 0 0 0 0 0 0 0 0 0 0 0 0 0 0 0
      0 0 0 0 0 0 0 0 0 0 0 0 0 0 0 0 0 0 0 0 0 0 0 0 0 0 0 0 0 0 0 0 0 0 0 0 0 0 0 0 0 0 0 0 0 0 0 0 0 0
      0 0 0 0 0 0 0 0 0 0 0 0 0 0 0 0 0 0 0 0 0 0 0 0 0 0 0 0 0 0 0 0 0 0 0 0 0 0 0 0 0 0 0 0 0 0 0 0 0 0
      )
    )
    (ghosttree
      (x 730)
      (y 550)
    )
   
    (camera
      (mode "normal")
      (path
        (node
          (x 0)
          (y 0)
        )
      )
    )
  )
)
